1111111111
100000C001
1000000001
1000C00001
1000000001
1000000001
10P000E001
1000000001
1111111111