111111
111C11
11C011
111P11
101011
1110C1
11E111
111111