111111
111C11
10C011
101P11
101011
1010C1
11E111
111111