111111
111C11
11C111
111P11
101111
1111C1
11E111
111111