1111111111
1CCCCCCCC1
1CCCCCCCC1
1CCCCCCCC1
1CCCCCCCC1
1CCCCCCCC1
1CPCCCECC1
1CCCCCCCC1
1111111111