111111
1E00C1
101C01
110001
10P001
111111