111111
1E00C1
101C01
100001
10P001
111111