1111111111111111111111111111111
1E0000000010C00000C000000000001
1010100110000111001111111110101
1010010001110001001000000010101
1P0000C10C0100000000000000100C1
1111111111111111111111111111111